3 3 3 3 3 3 3 3 3 3 3 3 3 5 0 L 0 5 3 3 3 3 3 3 3 3 3 3 3 3 3 3
3 3 3 3 3 3 3 3 3 3 3 3 3 5 0 L 0 5 3 3 3 3 5 5 5 5 5 5 5 5 5 5
3 3 3 3 3 3 3 3 3 3 3 3 3 5 0 L 0 5 3 5 5 5 5 0 0 0 0 0 0 0 0 0
5 5 5 5 5 5 5 5 5 5 5 5 5 5 0 L 0 5 5 5 0 0 0 0 0 0 0 0 0 0 0 0
0 0 0 0 0 0 0 0 0 0 0 0 0 0 0 L 0 0 0 0 0 0 0 0 0 0 0 0 0 0 0 0
0 0 0 0 0 0 0 0 0 0 0 0 0 0 0 L 0 0 0 0 0 0 0 0 0 0 0 L 0 99 0 0
0 0 0 0 0 0 0 0 0 0 0 0 0 0 0 L 0 0 0 0 0 0 0 0 0 0 0 L 5 5 5 5
0 99 0 0 0 0 0 0 0 0 0 0 0 99 0 L 0 99 0 0 0 0 0 5 5 0 0 L 5 3 3 3
5 5 5 0 0 0 5 5 0 0 0 5 5 5 5 5 5 5 5 5 0 0 0 5 5 0 0 L 5 3 3 3
3 3 5 0 0 0 5 5 0 0 0 5 3 5 0 0 0 0 0 0 0 0 0 3 3 0 0 L 5 3 3 3
3 3 5 0 0 0 5 5 0 0 0 5 3 5 0 0 0 0 0 0 0 0 0 3 3 0 0 L 5 3 3 3
3 3 5 0 0 0 5 5 0 0 0 5 3 5 0 L 0 0 0 0 0 0 0 3 3 0 0 0 5 3 3 3
3 3 5 0 0 0 5 5 0 0 0 5 3 5 0 L 5 5 5 5 0 0 0 5 5 0 0 0 5 3 3 3
3 3 5 0 0 0 5 5 0 0 0 5 3 5 0 L 0 5 0 5 0 0 0 5 5 0 0 0 5 3 3 3
3 3 5 0 0 0 5 5 0 0 0 5 3 5 0 L 0 5 0 5 0 0 0 5 5 0 0 0 5 3 3 3
3 3 5 9 9 9 5 5 9 9 9 5 3 5 0 L 0 5 0 5 9 9 9 5 5 9 9 9 5 3 3 3