5 5 5 5 5 5 5 5 5 5 5 5 5 5 5 5 5 5 5 5 5 5 5 5 5 5 5 5 5 5 5 5
5 0 0 0 0 0 0 0 L 0 0 0 0 0 0 0 0 0 0 0 L L L L 0 0 0 0 0 0 0 5
5 D 0 0 0 R 0 0 0 0 0 L 0 0 0 b 0 0 0 0 0 0 0 0 0 0 0 0 0 0 0 5
5 5 5 5 5 5 5 0 0 0 5 L 5 5 5 5 5 5 0 0 0 0 0 0 0 0 0 0 c 0 0 5
5 0 0 0 0 0 0 0 0 0 0 L 0 0 0 0 0 0 0 0 0 0 0 0 0 0 5 5 5 5 5 5
5 0 0 0 0 0 0 0 0 0 0 L 0 0 0 0 0 d 0 0 0 0 0 0 0 0 5 5 5 5 5 5
5 L 0 0 0 0 0 0 0 0 0 L 0 0 0 0 0 0 0 0 0 0 R 0 0 0 0 0 0 0 0 0
5 L 5 5 5 5 5 0 0 0 5 5 5 5 0 0 0 5 5 5 5 5 5 0 0 L 0 0 99 0 0 0
5 L 0 0 0 0 0 0 0 0 0 0 0 0 0 0 0 0 0 0 0 0 0 0 0 L 5 5 5 5 5 5
5 L 0 C 0 0 0 0 0 0 0 0 0 0 W 0 0 0 0 0 0 0 0 0 0 L 0 0 0 0 0 5
5 L 0 0 0 0 0 0 0 0 0 D 0 0 0 0 0 0 0 b 0 0 0 0 0 L 0 0 b 0 0 5
5 5 5 5 5 5 5 0 0 0 5 5 5 5 5 5 5 5 5 5 5 5 5 0 0 5 5 5 5 5 5 5
5 5 5 5 5 5 5 0 0 0 5 5 5 5 5 5 5 5 5 5 5 5 5 0 0 5 5 5 5 5 5 5
5 0 0 0 0 0 0 0 0 0 0 0 0 0 0 0 0 0 0 0 0 0 0 0 0 0 0 0 0 0 0 5
5 0 0 0 0 0 0 0 0 0 0 0 0 0 0 0 0 0 0 0 0 0 0 0 0 0 0 0 0 0 0 5
9 9 9 9 9 9 9 9 9 9 9 9 9 9 9 9 9 9 9 9 9 9 9 9 9 9 9 9 9 9 9 9