5 5 5 5 5 5 5 5 5 5 5 5 5 5 5 5 5 5 5 5 5 5 5 5 5 5 5 5 5 5 5 5
5 0 0 0 0 0 0 0 0 0 0 0 5 3 5 0 0 0 0 0 0 0 0 0 0 L 0 0 0 0 0 5
5 0 0 0 0 0 0 0 0 0 M 0 5 3 5 L 0 0 0 0 0 0 c 0 0 0 0 0 0 b 0 5
5 W 0 0 0 0 0 0 0 0 0 0 5 3 5 L 5 5 5 5 5 5 5 5 0 0 0 5 5 5 5 5
5 0 0 0 0 0 0 0 5 5 5 5 5 3 5 L 0 0 0 0 0 5 3 5 0 0 0 5 0 0 0 5
5 5 5 5 5 L 0 0 5 5 5 5 5 3 5 L 0 0 0 0 0 5 3 5 0 0 0 5 0 0 0 5
5 5 5 5 5 L 0 0 0 0 0 0 5 3 5 L 0 0 0 0 0 5 3 5 0 0 0 5 5 5 5 5
5 0 0 0 0 L 0 0 0 0 0 0 5 3 5 0 0 0 0 0 0 5 3 5 0 0 0 0 0 0 0 0
5 0 0 0 0 0 0 0 0 0 0 0 5 5 5 0 0 L 0 0 L 5 3 5 0 0 0 0 99 0 0 0
5 R 0 0 0 0 0 0 0 0 0 0 0 0 0 0 0 L 5 5 L 5 3 5 0 0 0 5 5 5 5 5
5 5 5 L 0 0 0 0 0 0 0 0 0 0 0 0 0 L 5 5 L 5 3 5 0 0 0 5 3 3 3 3
5 0 d L 0 0 0 0 0 0 0 0 0 0 0 0 0 L 5 5 L 5 5 5 0 0 0 5 3 3 3 3
5 0 0 0 0 0 0 0 0 0 0 0 0 0 0 0 0 L 5 5 L 0 C 0 0 0 0 5 3 3 3 3
5 5 5 5 5 5 5 5 5 5 5 5 0 0 0 5 5 5 5 5 0 0 0 0 0 0 0 5 3 3 3 3
5 0 0 0 0 0 0 0 0 0 0 5 0 0 0 5 3 3 3 5 0 5 5 5 0 0 0 5 3 3 3 3
5 5 5 5 5 5 5 5 5 5 5 5 9 9 9 5 3 3 3 5 9 5 3 5 9 9 9 5 5 3 3 3