5 5 5 5 5 5 5 5 5 5 5 5 5 5 5 5 5 5 5 5 5 5 5 5 5 5 5 5 5 5 5 5
5 0 0 0 0 0 0 L L 0 0 0 0 0 0 0 0 0 0 0 0 0 0 0 0 0 0 0 0 0 0 5
5 0 0 0 0 0 0 0 0 0 0 0 0 0 0 0 0 0 0 0 0 0 0 0 0 0 0 0 0 0 0 5
5 L 0 0 0 0 0 0 0 0 0 0 0 0 0 5 5 0 0 5 5 0 0 0 0 0 0 0 0 0 0 5
5 L 5 5 5 0 0 0 0 0 0 b 0 0 0 5 5 0 0 0 0 0 0 0 0 0 0 0 0 c 0 5
5 L 0 0 0 0 0 0 0 0 5 5 5 0 0 5 5 0 0 0 0 0 0 5 5 0 0 0 5 5 5 5
5 L 0 0 0 0 0 0 0 0 0 0 5 0 0 5 5 0 0 0 0 0 0 0 0 0 0 0 0 0 0 5
5 L 0 0 0 0 0 0 0 0 0 0 L 0 0 5 5 0 0 0 0 0 0 0 0 0 0 0 0 0 0 5
5 5 5 5 5 0 0 0 0 0 0 0 L 0 0 0 0 0 0 0 0 0 0 0 0 0 0 0 0 0 0 5
5 0 0 0 5 0 0 0 0 5 5 0 L 0 0 0 0 0 0 0 0 0 0 0 0 0 0 0 0 M 0 5
5 5 5 5 5 0 0 0 0 0 0 0 L 0 0 0 0 C 0 0 0 0 0 D 0 0 0 0 0 0 0 5
0 0 0 0 0 0 0 0 0 0 0 0 L 0 0 0 0 0 0 0 0 0 0 5 5 5 5 5 5 5 5 5
0 0 99 0 0 0 0 0 0 0 0 0 0 0 0 5 5 5 5 5 0 0 0 5 0 0 0 0 0 0 0 0
5 5 5 5 6 0 0 0 4 6 0 0 0 0 0 5 0 0 0 5 0 0 0 5 0 0 0 0 0 0 0 0
5 5 5 5 5 0 0 0 5 5 0 0 0 0 0 5 0 0 0 5 0 0 0 5 0 0 0 0 0 0 0 0
5 5 5 5 5 9 9 9 5 5 9 9 9 9 9 5 0 0 0 5 9 9 9 5 0 0 0 0 0 0 0 0