5 5 5 5 5 5 5 5 5 5 5 5 5 5 5 5 5 5 5 5 5 5 5 5 5 5 5 5 5 5 5 5
5 0 0 0 0 0 0 0 0 0 0 0 0 0 0 0 0 0 0 0 0 0 0 0 0 0 0 0 0 0 0 5
5 0 0 0 0 0 0 0 0 0 0 0 0 0 0 0 0 0 0 0 0 0 0 0 0 0 0 0 0 0 c 5
5 D R 0 0 0 0 0 0 0 0 0 0 0 0 0 0 0 0 0 0 0 0 0 0 0 0 0 0 0 5 5
5 5 5 5 5 5 5 5 5 5 5 5 5 5 5 0 0 5 5 5 0 0 5 5 0 0 0 0 0 0 0 5
5 5 5 5 5 0 0 0 0 0 0 0 0 0 0 0 0 0 0 0 0 0 0 0 M 0 5 0 0 0 0 5
0 0 0 0 5 0 0 0 0 0 0 0 0 0 0 0 0 0 0 0 0 0 0 0 0 0 5 0 0 0 0 5
0 0 0 0 5 0 W 0 0 0 0 0 0 0 0 0 C 0 0 0 0 5 5 5 5 5 5 0 0 0 0 5
5 5 L 5 5 0 0 0 0 0 0 L 0 0 0 0 0 0 0 0 0 0 0 0 0 0 0 0 0 0 0 5
5 5 L 5 5 5 5 5 5 5 5 L 5 5 5 5 5 5 5 5 5 0 0 0 0 0 0 0 0 0 0 5
5 0 L 0 0 0 0 0 0 0 0 L 0 0 0 0 0 0 0 0 0 0 0 0 0 0 0 0 0 0 0 5
5 0 0 0 99 0 b 0 0 0 0 L 0 0 0 0 b 0 0 0 0 0 0 0 0 D 0 0 0 0 R 5
5 5 5 5 5 5 5 5 5 5 5 5 5 5 5 5 5 5 5 5 5 5 0 0 0 5 5 5 5 5 5 5
5 0 0 0 0 0 0 0 0 0 0 0 0 0 0 0 0 0 0 0 0 0 0 0 0 0 0 0 0 0 0 5
5 D 0 0 D 0 0 0 0 D 0 0 0 0 0 D 0 0 0 0 D 0 0 0 0 D 0 0 0 0 0 5
5 5 5 5 5 5 5 5 5 5 5 5 5 5 5 5 5 5 5 5 5 5 5 5 5 5 5 5 5 5 5 5