7 23 23 23 23 23 23 23 23 23 23 23 23 23 23 23 23 23 23 23 23 23 23 23 23 23 23 23 23 23 23 8
15 0 0 0 0 0 0 0 0 0 0 0 0 0 0 0 0 0 0 0 0 0 0 0 0 0 0 0 0 0 0 13
15 d 0 0 0 0 0 0 0 0 0 0 0 0 0 0 0 0 0 0 0 0 0 0 0 0 0 0 0 0 c 13
15 0 R 0 0 0 0 0 0 0 0 0 0 0 0 0 0 0 0 0 0 0 0 0 0 0 0 0 0 0 25 13
16 5 5 5 6 25 25 25 25 25 25 25 25 25 25 0 0 25 25 25 0 0 25 25 0 0 0 0 0 0 0 13
5 5 5 5 25 0 0 0 0 0 0 0 0 0 0 0 0 0 0 0 0 0 0 0 M 0 25 0 0 0 0 13
0 0 0 0 25 0 0 0 0 0 0 0 0 0 0 0 0 0 0 0 0 0 0 0 0 0 25 0 0 0 0 13
0 0 0 0 25 0 W 0 0 0 0 0 0 0 0 0 C 0 0 0 0 25 25 25 25 25 25 0 0 0 0 13
5 6 L 4 25 0 0 0 0 0 0 L 0 0 0 0 0 0 0 0 0 0 0 0 0 0 0 0 0 0 0 13
7 24 L 22 25 25 25 25 25 25 25 L 25 25 25 25 25 25 25 25 25 0 0 0 0 0 0 0 0 0 0 13
15 0 L 0 0 0 0 0 0 0 0 L 0 0 0 0 0 0 0 0 0 0 0 0 0 0 0 0 0 0 0 13
15 0 0 0 99 0 b 0 0 0 0 L 0 0 0 0 b 0 0 0 0 0 0 0 0 D 0 0 0 0 R 13
15 25 25 25 25 25 25 25 25 25 25 25 25 25 25 25 25 25 25 25 25 25 0 0 0 25 25 25 25 25 25 13
15 0 0 0 0 0 0 0 0 0 0 0 0 0 0 0 0 0 0 0 0 0 0 0 0 0 0 0 0 0 0 13
15 0 0 0 0 0 0 0 0 0 0 0 0 0 0 0 0 0 0 0 0 0 0 0 0 0 0 0 0 0 0 13
15 9 9 9 9 9 9 9 9 9 9 9 9 9 9 9 9 9 9 9 9 9 9 9 9 9 9 9 9 9 9 13