0 0 0 0 0 0 0 0 0 0 0 0 0 0 0 0 0 0 0 0 0 0 0 0 0 0 0 0 0 0 0 0
0 0 0 0 0 0 0 0 0 0 0 0 0 0 0 0 0 0 0 0 0 0 0 0 0 0 0 0 0 0 0 0
0 0 0 0 0 0 0 0 0 0 0 0 0 0 0 0 0 0 0 0 0 0 0 0 0 0 0 0 0 0 0 0
0 0 0 0 0 0 0 0 0 0 0 0 0 0 0 0 0 0 0 0 0 0 0 0 0 0 0 0 0 0 0 0
0 0 0 0 0 0 0 0 0 0 0 0 0 0 0 0 0 0 0 0 0 0 0 0 0 0 0 0 0 0 0 0
0 0 0 0 0 0 0 0 0 0 0 0 0 0 0 0 0 0 0 0 0 0 0 0 0 0 0 0 0 0 0 0
0 0 0 0 0 0 0 0 0 0 0 0 0 0 0 d 0 0 0 0 0 0 0 0 0 0 0 0 0 0 0 0
0 0 99 0 0 0 0 0 0 c 0 0 0 0 0 0 0 0 0 0 0 0 0 0 R 0 0 0 0 0 0 0
5 5 5 5 6 L 0 0 4 5 6 0 0 0 4 5 5 5 5 5 5 5 5 5 5 6 0 0 0 0 0 0
3 3 3 3 15 L 0 0 22 23 24 0 0 0 22 23 23 23 23 23 23 23 23 23 23 24 0 0 0 0 0 0
3 3 3 3 15 L 0 0 0 0 0 0 0 0 0 3 3 3 0 0 0 0 3 3 3 0 0 0 0 0 0 0
3 3 3 3 15 L 0 0 0 C 0 0 0 0 0 3 3 3 0 0 0 0 3 3 3 0 0 0 0 0 0 0
3 3 3 3 15 0 0 0 0 0 0 0 0 0 0 3 3 3 0 0 D 0 3 3 3 0 0 0 0 0 0 0
3 3 3 3 16 5 5 5 5 5 5 5 5 5 5 5 5 5 5 5 5 5 5 5 5 5 5 5 5 5 5 5
3 3 3 3 3 3 3 3 3 3 3 3 3 3 3 3 3 3 3 3 3 3 3 3 3 3 3 3 3 3 3 3
3 3 3 3 3 3 3 3 3 3 3 3 3 3 3 3 3 3 3 3 3 3 3 3 3 3 3 3 3 3 3 3