0 0 0 0 0 0 0 0 0 0 0 0 0 0 0 0 0 0 0 0 0 0 0 0 0 0 0 0 0 0 0 0
0 0 0 0 0 0 0 0 0 0 0 0 0 0 0 0 0 0 0 0 0 0 0 0 0 0 0 0 0 0 0 0
0 0 0 0 0 0 0 0 0 0 0 0 0 0 0 0 0 0 0 0 0 0 0 0 0 0 0 0 0 0 0 0
0 0 0 0 0 0 0 0 0 0 0 0 0 0 0 0 0 0 0 0 0 0 0 0 0 0 0 0 0 0 0 0
0 0 0 0 0 0 0 0 0 0 0 0 0 0 0 0 0 0 0 0 0 0 0 0 0 0 0 0 0 0 0 0
0 0 0 0 0 0 0 0 0 0 0 0 0 0 0 0 0 0 0 0 0 0 0 0 0 0 0 0 0 0 0 0
0 0 0 0 0 0 0 0 0 0 0 0 0 0 M 0 0 W 0 0 0 0 0 0 0 0 0 0 0 0 0 0
0 0 0 0 0 0 0 0 0 b 0 R 0 0 0 0 0 0 0 0 0 0 0 0 0 0 0 0 0 0 0 0
5 5 5 6 0 0 0 4 5 5 5 5 5 5 5 5 5 5 5 5 6 0 0 0 L 4 5 5 5 5 5 5
3 3 3 15 0 0 0 22 23 23 23 23 23 23 23 23 23 23 23 23 24 0 0 0 L 13 3 3 3 3 3 3
3 3 3 15 0 0 0 0 3 3 0 0 0 3 3 0 0 0 3 3 0 0 0 0 L 13 3 3 3 3 3 3
3 3 3 15 0 0 0 0 3 3 0 0 0 3 3 0 0 0 3 3 0 0 0 0 L 13 3 3 3 3 3 3
3 3 3 15 0 0 0 0 3 3 0 0 0 3 3 0 0 0 3 3 0 0 0 0 L 13 3 3 3 3 3 3
3 3 3 16 5 5 5 5 5 5 5 5 5 5 5 5 5 5 5 5 5 5 5 5 5 17 3 3 3 3 3 3
3 3 3 3 3 3 3 3 3 3 3 3 3 3 3 3 3 3 3 3 3 3 3 3 3 3 3 3 3 3 3 3
3 3 3 3 3 3 3 3 3 3 3 3 3 3 3 3 3 3 3 3 3 3 3 3 3 3 3 3 3 3 3 3